00000000000000000000000000000000000000000000000000
00000000000000000000000000000000000000000000000000
00000000000000000000000000000000000000000000000000
00000000000000000000000000000000000000000000000000
00000000000000000000000000000000000000000000000000
00000000000000000000000000000000000000000000000000
00000000000000000000000000000000000000000000000000
00000000000000000000000000001000000000000000000000
00000000000000000000000000010100000000000000000000
00000000000000000000000000100010000000000000000000
00000000000000000000000001001001000000000000000000
00000000000000000000000010010100100000000000000000
00000000001111111111111100100010010000000000000000
00000000001000000000000000111110001111000000000000
00000000001011111111111100000000000001000000000000
00000000001010001001000101111111111101000000000000
000000000010100010010001S1000000000101000000000000
00000000001010001001001000100000000101000000000000
00000000001010001000010000010000000101000000000000
00000000001010001000100000001000000101000000000000
00000000001010001001000000000100000101000000000000
00000000001010001010000000000010000101000000000000
00000000001010000100000000000001000101000000000000
00000000001010001000000000000000100101000000000000
00000000001010010000000000000000010101000000000000
00000000000000111111111111111111111101000000000000
00000000001010010000000000000000010101000000000000
00000000001010001000000000000000100101000000000000
00000000001010000100000000000001000101000000000000
00000000001010000010000000000010000101000000000000
00000000001010010001000000000100000101000000000000
00000000001010010000100000001000000101000000000000
00000000001010010000010000010000000101000000000000
00000000001010010000001000100000000101000000000000
000000000010100100001001E1000000000101000000000000
00000000001010010000100001111111111101000000000000
00000000001010010000100100000000000001000000000000
00000000001011111111111101111111111111000000000000
00000000001000000000000001000000000000000000000000
00000000001111111111111111000000000000000000000000
00000000000000000000000000000000000000000000000000
00000000000000000000000000000000000000000000000000
00000000000000000000000000000000000000000000000000
00000000000000000000000000000000000000000000000000
00000000000000000000000000000000000000000000000000
00000000000000000000000000000000000000000000000000
00000000000000000000000000000000000000000000000000
00000000000000000000000000000000000000000000000000
00000000000000000000000000000000000000000000000000
00000000000000000000000000000000000000000000000000
