000000000000100100010000100100000000010000000100S1
00000000000010010001000010001000000010001001010011
00000000000010010101010010000100000100001001000101
00111000111010010101010010010010001000101000001001
00100000001000000100010000010001000000100100010001
00100000001000000100010000010000000000000010100001
00100000001110011111111111111111111111001111111111
00100000000000000100000000000000000000001000000000
00000000001000000100011111111111111111001000000000
00000000001000000110010000000000000101001000011111
00111111111000000010010000111100100101001000000100
00100000000000000010010000100100100101001000011111
00100010000000000010011111100100100101001000000000
00000010000000000010000000000100100101001000011111
00111111111100000011111110000100100001001000010101
00000000000100000000000011111100000001001000010101
00000000000100000000000000000000011111001111000000
00000000000101111000000000000000010000000001000000
00111111111101001001111000100000010000000001011111
00100010000101001001001000100000010000000001000001
00000001000101001001001010101111010000000001000000
00000000100101001001001010101001010000000001011111
00100010010101001001001110101001010000000000000001
00111111001111001001000000101001010111111000000000
00000000100100001001000000001111010100001000011111
00000000010010001001000000000000010100101000010001
00000000001001001001111111100000010100101000011111
00111111000100101000000000100111010100101000000000
00000001000010011000000000100101010100101000000000
00000001000001000000000000100111010100101001000000
00000001000000101111111110100000010100101001011111
00111111111000101000000010100000011100001001000001
00000001000000101000100011100010000000101001011111
00000000000000101000100000000010000001001001000001
00111111111111101000100000000010000010001001011111
00100001001000001000100000000010000100101001000000
00100000001000001000000000000000001E00011111000001
00100001000000001111111111111111111111001000100000
00000001111111100000000000000000000001001000000000
00000000000001000001111111111111111111001000000100
00100010001001000001000000000000000000001000000000
00100010001001000001111111111111111111011111111010
00100010001001000000000000000000000000000000001001
00111111111001001111111111111111111110101111111001
00000000000001001000000000000000000000000000000001
00111111111001001000111111111111111111111111111001
00100000001001001000100000000000000000000000000000
00100000001001001000111111100000000000000000000000
00100000001001001000000000111111111111001111111111
00111111111001001000000000000000000000000000000000
