00100000001000010010000000100000000101100000101100
00001000000010100000001011000000001010000110000010
00000100111000011111000110000000011001101110101010
01000010000001011000101100100010010011010000001000
10011001001000110000001100011010010010110001101000
00100000100000000000010000100100011000101000000000
100000000001010001000111011010101100000010000E0000
00110011000000011000000001000000010011000000000011
00101110000000001001000000010100010001101000000100
00010011001001011100010000000010000000001001001000
10111010001000001000001100010010010000001100011010
00001000000110100101001010111100001100000000000001
00101110010000110001100000000110000001000101001000
00010000010101101101110001010110011010011100000001
01001101001000010110000101010001101000001100000001
00000100000011000000100010101100100000000010010001
01010001010100100111100110010000111000100010010101
01100011000000000100011000011010010110101000100111
10000000100001000101000011000110000000010011100010
00010001001110001100010101100111100000000000001001
00101001100000000001010001000111000000110000000010
10000110100100001010001001100000110100010100000000
10000000110000001100010101001000000110010011001010
00010100010011001010010011100110101010000100000000
00000100000100101000010000010000000001110000010000
00100100011101110100010000100000000100010000110011
10010000011000100101000000000101001010000011001010
10001000100100100000011000010010001000001110010001
00001000001100100000000011000100000010101000010100
10101100000001000000000100100010110101000000110010
00001000000110000011000000001111001000010101000101
00100001001000001100100011100011100000001011010000
00010010000100000100000111010001010000101101000000
00100000000000001101000000010110100000010010000000
00001000010000000010110000001010000001010000001001
10000011000110111100101100010100000101010000000100
10000000010000011001000001000000100000010100100001
00100001000100110011110110000000100010001010000111
00000100000001011000001010100100000010000000110000
01000110000100110000000100001000010000001100100001
10101010000001101001000101011100001010000110101001
10110010010000100000000001011000000100010010001011
00100110100010110011001101111000001001011110100000
10000001100100000000001000001110101001000000100000
00010000100100001001010000011010011000000111000100
10100000001000000000000000000111100001010110001000
10110001010100001111110001100000001000110001100010
01001000010010100100000001000000001100100000010000
0000000000010010S011011001001100100110010110011011
01100001100000010011010001001101001000000010000010
