00000000000000000000000000000000000000000000000000
01111111111111111111111111111111111111111111111100
01000000000000000000000000000000000000000000000100
01000000000000000000000000000000000000000000000100
01000000000000000000000000000000000000000000000100
01000000000000000000000000000000000000000000000100
01000000000000000000000001111111100000000000000100
01000000000000000000000000000100000011111111111100
01000000000000000000000000000100000010000000000000
01000000000011111000000001111111100010000000000000
01111111111110001000000000000000000010000000000000
00000000000000S01000000001111111100010000000000000
00000000001110001000000001000100101110000000000000
00000000001011111000000001000100101000000000000000
00000000001000000000000001000100101000011111000000
00000000001001000000000000000000001010000001000000
00000000001001000000000001111111101010000001000000
00000000001001111111111100000000101010000001000000
00000000001001000000000000000000101011111111000000
00000000001001000000000001111111101010000000000000
00000000001001000000000000000000101010000000000000
00000000001000000000000000000000101011111111000000
00000000001000000001111100000000001010000001000000
00000000001000000001010101111111101010000001000000
00000000001000000001010101000000101011111111000000
00000000001000000000000001000000101000000000000000
00000000001000000000000001111111101000000000000000
00000000001000000000000000000000001111111111111111
00000000001000000001110100000000000000000000000001
00000000001000000001010100000000000000000000000001
00000000001000000001011100000010001111111111111101
00011111111000000000000000001001001000000000000101
0001000000000000000000000E010010001000000000000101
00010000000000000001000000001000001011111111000101
00010000000000000001000000000000001010000001000101
00010000000000000001111100000100001010000111111101
01110000000000000001000000001000001010000001000001
01000000000000000001000000000100001011111111011111
01000000000000000001000000000000001000000000010000
01111111111000000000000000000000001011111111110000
00000000001000000000000000000000001000000001000000
00001111111000000000000000000000001000000001000000
00001000000000000000000000000000001000000001000000
00001000000000000000000000000000001011111111000000
00001000000000000000000000000000001000000000000000
00001111111111111111111111111111111011111111000000
00000000000000000000000000000000000000000000000000
00000000000000000000000000000000000011111111000000
00000000000000000000000000000000000010000000000000
00000000000000000000000000000000000010000000000000
