00000000000000000000000000000000000000000000000000
00111111100000000000000000000000000000000000000000
00000000100000000000000000000000000011111111110000
00000000100000000000000000000000000010000000010000
00000000100000000000000000000111111110000000010000
00111100100000000000000000000100000000000000011100
00100100100001111110000000000100000000000000000100
00100100100001000010000000000111111110001000000100
00100100100001000010000000000000000010001000100110
00100100100001000010000000000000000010001000100010
00100100100001000011111110000000000010001000100010
00100100111111000000000010000000000010001000000010
00100100000000000000000010000011111110001111000010
00100100000000000000000010000010000000000001000010
00100100000000000000000010000010000000000001001010
00100100001111111111111110000011111000111101001010
00100100001100000000100000000000001000100101001010
00100100001010000000010000000000010000100101001010
00100100001001000000001000000000100000111101001010
00100100001000100000000100000000000000000001001010
00100100001000010000000010000010111110000001001010
00100100001000001000000001000100100010000001000010
001001000010001001000000001S1000100010000001000010
00100100001001010010000000010000100010000001000010
001001000010100010010000001E1000111110000001010010
00100100001001000100100001000100000000000001010010
00100100001000100010010010101010000000111101010010
00100100001000010001001100000101000000100101010000
00100100000000001000100001000010100000111101010000
00100100000001001100010010000001010000000001010111
00100100000001001010100100000000101000000001000100
00100100000001001001111111111111111111100111000100
00100100001001001000000001000000000000100100000100
00100100001001000000010000011100000000100100000100
00100100001000000000010001010100111111100100000100
00100100001111111111111111010100100000000111100111
00100100000000000000000000011111100000000000000000
00100100000000000000000000000000000000000000000000
00100100000000000111011111111111111111111111111110
00100100000000000101010000000000000000000000000010
00100111110000111101010000000000000000000000000010
00100000010000100001011111111111111100000000000010
00100000010000100001000000000000000100000000000010
00100000010000100001000011111100000100000000000010
00100000011111100001000010000100000100000000000010
00111000000000011101111110000100000111111111111110
00001000000000010100000001110111100000000000000000
00001111111111110100000001010000100000000000000000
00000000000000000111111111011111111111111000111111
00000000000000000000000000000000000000000000000000
