00000000000000000000000000000000000000000000000000
01111111111111111111111111111111111111111111111100
01000000000000000000000000000000000000000000000100
01000100010001001000010111111111111111111110000100
01000100001000100100010000000000000000000000000100
01000100000100010010010000000000000011111110000100
01000100100010001001000001111111100000000000000100
01000100100001000100100000000100001000000111111100
01000100100000000010010000000100001011110100000000
01000000000011111001001001111111101010010100000000
11111111111110001000100100000000000010000100000000
00000000000000S01000101001111111100010011100000000
00000000001110001001010001000100101110000000000000
11000111111011111010100001000100101111110000000000
00101000001000100101000001000100101010E11011000000
01000100001000101010000000000000001010000001000000
00100010001000110100000001111111101010000001000000
00010001001000111111111100000000101010000001000000
00100000101000100000000000000000101011111111000000
00010000011000100000000001111111101010000000000000
00001000101000100000000000000000101010000000000000
00010001001000100000000000000000101011111111000000
00100010001000111111111100000000001010000001000000
01000100001000100010000101111111101010000001000000
10001000001000100010000101000000101011111111000000
10010000001000100010000101000000101000000000000000
10010000001000100010000101111111101000000000000000
10010000001000100010000100000000001111111111111111
10010000001000111111000110000000000000000000000001
10010000001000100001000101000100000000000000000001
10010000001000100001000100100010001111111111111101
10011111111000100001000100010001001000000000000101
10010000000000100001111100001000101000000000000101
10010000000000100000000000000100011011111111000101
10010000000000100000000000000010001010000001000101
10010000000000100000000000001000001010000111111101
10010000000000111111111100010000001010000001000001
10010000000000100000000000100000001011111111011011
10010000000000100000000001000000001010000000010000
10011111111000100000000010000000011011111111110000
10000000001000100000000100010000101000000001000000
10001111111000100000001000100001001000000001000000
10001000000000000000010001000010001000000001000000
10001000000000000000000010000100001011111111000000
10001000000000000000000100001000001000000001000000
10001111111111111111111111111111111011111111000000
10010010010000001000000010000010000000000001000000
10100100100010010000100100010010010011111011000000
10000000000100000001000000100000010010000001000000
11111111111111111111111111111111111110000000000000
