00100101001100100111001000111000000100111100001000
01100101000000100001000001000001100010000101110000
00000000010010010110000111000110100011001010000000
00100000100100010010000110000010001010001100010011
10000001000111110000000000101100100000000100000000
01100010110111101111000001100000010100111000101011
10001001100101000000000001000000001000000001011011
00101000000000000001001000000101101000000000000000
01001010101011001000000010010100110000010001000000
00001110110100011000100000101000010000101110100000
00010010111010101100100100110000101011111010010010
00001110101100000000110011010001010001001110001000
10010111010000000010011010000000000000111010100110
01000100000001000001111011001010000000010100110100
00000111101100101100000101011000100011000001000000
10000001010000100010000000000000111010100000001100
00010000000100000000100100000000100100001000010000
01010110000100000000000100110000001000100110000010
00000001010000100001001101000110000101100001111000
00010000011100100000100101100000010111010010011010
00000010110000000000100000000001010100000110001000
10101001000110010010100111010010000100000010010110
11011000010011000100011001000000100100100000000001
01111000011000E00100101010010110001000001000100101
10110010010000011000010000001010010000100000010000
00000000000100000100110001101000001011000000101011
00000000000000000100011001100001010001110010000010
10000101000001100000011011000100000001000000000000
11101000100000010000000101100000001000000000101000
11000000000011000000001100010110100100110000100100
11010000000000010101110001100010011100000100010000
00000101100001010010010101001000100000110111000100
00000000100000110111001000000001110011010010000000
01011001011101001101001100110010100001000101001000
01000000000100000000110001000001001010001010010101
01000110001001000000001000101000101010001001000101
00000000000001001000111101000000000000000101000000
00100011001001011100000000000010100010100000000000
S0000001000001000010110010110110100110000010001000
10000000001000000000100100000010000101000000000001
00010000001001000000110000000000000000101001001010
10100011000011000000001110110000000001000000010000
00110111001000000100011000000010110011010000011011
00011000111000001111001000011000000001010101010010
10001101010101000010101000000100000000100000000000
00101011000101000110001010110000101000101000111110
11000010000010000001001011001101010111000010000010
10111000000111100100000110000000000100010000111100
00101111000001000100000000110110000100100010100000
11101000100000001110100000000011000100000000000000
