01000000001000100111101000000100100010011000000100
00000100000001100000011010010010100101010010000010
00001100000000101101000100010011001110000100000101
00011010001010010010110010000111001010101000100011
01101000001011010000000000001000011110000000010000
00101000000001011000001000100000010001101110000100
10110001010000000100101100100100010000000000001010
01000001000000000000101000110010011001010010000001
10010000000000000100001001000110100001001001000000
00000000010001010100000110001100001110010000100000
00100000010111001100010100000101000010000011100001
00000000100010000100001000010111100110111000001010
10000110010100100000001010110000100011100001001100
10101111011010100100001000010111010101000100001111
00000000100000111100010011000000100010000110000100
10000010000000110010010011110000000010000000001101
00000110011100001001000101001000110000100000000110
10010110100000010100001001011010000000100000000000
00010101110001000000000100000100000001101011000100
10001000010011100001100011111111100100010100001000
00000000000001101001000000011001100100011000101011
00001011001100110100100000000000101011001001010000
00000000001100000000000000001111000001000001010001
10000000100100000101111001000101000100000110001100
00010001001101000000010000010001000110001000011111
0000001110011010010000100010001101011000000000001E
01101100001000010010100000001001111000001000000000
10000000000010000010001100010101011000000010100110
01111001101100000000100110011100001000010100011110
00001000011011000000000001000000000000001001000000
01000000100100110111000100001000001100000101111000
00101000011000110100000000101000110000001001110010
10011010011000010011010100010001010001010001001011
00000000101000010100000100011010010110100011001000
10101001000101100000000010000110000000011000100110
10100001000000001010001100001110001001100000101001
00100010100010100000101001000110000111100000010000
11000010010000001001000010000000000000000000001001
10001100000000100000011100010101000110110010100010
01010000011000000000000101111000010101101100010010
10100110001000001000000101000000101000101010111000
110100001011100000100000001010S0001000000000000110
00000000010001010100001110000100000000000000001001
00011001010000110101000000001111000001110000001101
01010100110011100000000000100001000100000000001011
00000010100001100000001110000011110110010010011000
01100001000110101001101010011000000000000100000000
10100011110001010010000000000001010001101000100000
00001000011001001011001100100100011011000111010010
10000100000000001010010010001001000001000100101000
