01011000000000010000110101000010010101100000001010
10100101010100001001101000000001111011001010110111
10001000100010011001001100000100000011000000110000
01101001010100010001000011100001001010010000000101
00001001010100100000011000000100010000001000100001
01101010100011000000000000000001110001011010000101
00000000000010000000010001100010011100000101100000
000000001000E0010001010101101000000100100000100011
10010100100000101100001101100010001011000010000010
00100101010100001001110011110001000001110000100010
11000100100101010100001100001001010010100001000110
01100100010101101010110110111101011000011100000000
10010010001010001000110000100010110100010000000000
00001000000010000101000010100100000000000000001010
11010100011110010000100000010000010111000010010100
00100101010101000000010000000010000001000000100111
00000110000100000001010000000000000000001000000100
10001111000110110000000010100011101001010010100011
01010101101000011011000001110110001100010100000100
00011000000000000001110010010101001000010110100011
00000010100100101000011000000010011110000001001010
00100000100110111010000001101000001000010001100100
00100011001010000101010100001000110000000101000100
00110101001011110011101011001000000000110111000000
01000011010000000101101010010000000101010000000001
11000010110110011000000000000100000000011001000110
01010100010001010010000000000010100000000100000000
10001000011001000000000011000000011001000100010010
10000011100000101101111010001010010001000100101111
01010011100110001010100001111011000001010101000001
00011100010000010011001000000001000001100000100001
10000000000100000001010001001011001001011000100101
00000010110000001110010S10011010010011110001100000
01011010001001110000100110001000000100000011010000
00010100101010000001101000001000000010000110100000
10001000000000010100001000001000110101000000100000
00000010100010000000100101000010111100010000001010
01010001100010101000000000110010100000001001011000
10110010000001000010000000110011010000100000010010
00000000001010001011000011111110001001101000010000
10000100001011001010000000000000011010001110000000
10110010101000000101010000101000000000100010001011
00010100001010010000100011110000110000011000100010
00000110011000000010101010001000000101001000001001
01000000111000010100010000111000100011101001001001
00100000010000010001001001001010100011001111000000
10000000001100000100101000001010110100100001000100
00010110000100000101010001011000011000100100000010
00011000100010000000000000001100001000001011010001
10111000000011000100101001000000000110000010000100
