00001010111101100101010000010010011011000100000001
11111001010010010010000101100000110110010000000101
01101010010100000010000000111101111100110100010001
11010001110110100100010101001100000010001001001100
00001001011100010010101000111010011100100010000101
00001100001000110000001100110101000000100100000100
01100000001000000100001100000111001010101001001000
10100001100111011000001110000010000101101100011011
10000100011000100101000100100000101000110000001010
00010000000000000000010011010000110110011001000100
00001000011101010001100110010000001000100110010111
10000011001001001000000011100000100000000010100000
01000000000011000000001001101110001111010000000011
00000000000001001010010100000000010110010100011000
00000000000110000001110000000100000000110010000100
01100000011011000001110000110000100101000100000011
00100000000111100001000001110000011110101000011001
01010001001010010001000000001000000001000010000100
00011000000001000001101001110000000011010100000000
00101000000000000001010000000100101010000010100000
10000000000100000010110001101010100011000011001101
10001010000110000110101010100000001001010101000001
00010001001010000101100000110101111011000001100000
10000000000000000011010101001011010000100010000100
00000100001000100010000000100010000010110101000100
10000100110111111110100100101010111100001010000010
00011101000000000101000001100000000010000000001000
00100010011010001010100001011100000010100011000100
10100010001100010000001000000111111000000110011101
00100000100100010000011110010010000110110101100000
10001001010000001001000000001001010000000000000100
11010001001010100000100010110000000000010001110000
110010001000000E1000100001001010011000010111000001
01010111000000001101011100110100010010010000001001
00000101110001011100101111000001000010110101101010
00100001111001000100011001000000000010101101111000
00000000001000000000100011110010000000000101011001
00001010001011011101110010000100100010000000011110
00000000000101011011001000110000010011100010001000
10101000111010110110010001010010011010011010101000
10000011001000000100110010000000010000100010111000
11001011100100010001000100110000001100011011000001
01111000010100001100110100000000001011001100110001
01010001010001010110100000111100001100101000010000
101001100110000000100101S0100011101000010000001100
01101100001111001000100111011010000010001010010111
01101101000011001000000010101010001001010000001000
00100000011000010000000000111000000010000000010000
01011101001000001000110000000000010111100001001100
00000000010000000001001010000101100000001001000000
